domainfactory GmbH	[domainfactory-kunde.de,domainfactory-euwhois.de,domainfactory.at,domainfactory.de,domainfactory-webmail.de]
ServerStack Inc.	[serverstack.com]
SunGard Availability Services LP	[sungardpsasp.com,sungardhe.com,sungardas.co.uk,sungardk12saas.com,sungardas.ie,sungardvaulting.com,mysungard.com,mysungard.co.uk,sungardas.se,mysungard.net,sungardas.com,mysungardas.co.uk]
Liquid Web Inc.	[liquidweb.services,liquidweb.com,liquidwebco.com]
Reflected Networks Inc.	[reflected.net]
UK Webhosting Ltd	[ukwebhosting.com]
NSK Co.Ltd.	[nskinc.com,nsk.ad.jp,nsk.ne.jp]
Gigya Inc.	[gigya.jp,gigya.com,gigya-cs.com]
TELECITYGROUP INTERNATIONAL LIMITED	[telecity.com.tw,telecity.net,telecitygroup.com,telecity.se]
Hostway Corporation	[hostway.com,hostway.net,hostway.com.au,hostway.co.uk,hostway.be,hostway.nl,hostwaypartner.com,hostways.nl,hostway.co.kr,hostway-enterprise.net,hostway.ro,hostwaycorp.com,hostway.co.il,hostway.de,hostwayenterprise.com,]
Webfusion Internet Solutions	[webfusion.net.au,webfusion-secure.co.uk,webfusion-secure.com,webfusion.com,webfusion.com.au,webfusion.bg,webfusion.co.uk,webfusion.es]
Peer 1 Network (USA) Inc.	[peer1sales.com,peer1.ca,peer1hosting.co.uk,peer1.com,mypeer1.com,peer1.net]
Colo at 55 LLC	[coloat.com]
Unified Layer	[unifiedlayer.com]
ViaWest	[viawest.net,viawest.com]
OVH SAS	[ovh.net,ovh.de,ovh.org.uk,ovh.nl,ovh.co.uk,ovh.fr,ovh.sk,ovh.lt,ovh.sn,ovh.ca,ovhsitebuilder.com,ovh.com,ovh.cz,ovh.ie,ovh.it,ovhtelecom.fr,ovh.me,ovh.es,ovh.pt,ovh.us,ovhmanager.com,ovh.pl,ovh.tn]
Peak 10	[peak10.com,peak10.net]
FiberRing B.V.	[fiberring.net,fiberring.com]
NEXCESS.NET L.L.C.	[nexcess.net.au,nexcessconsulting.com,nexcesscdn.net,nexcess.net,nexcess-status.com,nexcess.co.uk]
SAKURA Internet Inc.	[sakura.ne.jp,nic.sakura,sakura.ad.jp]
CloudFlare Inc.	[cloudflareapi.com,cloudflare-dnssec-cname.com,cloudflarepreview.com,cloudflare-azure.com,cloudflare-identity.com,cloudflare-url-protection.com,cloudflare-dnssec-auth.com,cloudflare-dnssec.com,cloudflaressl.com,cloudflare.co.id,cloudflare-dnssec.net,cloudflarestatus.com,cloudflare-url-check.com,cloudflare-url-check.net,iscloudflareenabled.com,cloudflare.us,cloudflare.com,cloudflarechallenge.com,cloudflare-secure.net]
Cyberverse Inc.	[cyberverse.com,cyberverse.net]
Rackspace Hosting	[myrackspace.co.uk,myrackspace.com,rackspacehosting.se,rackspacestartups.com,rackspace.co.uk,twcrackspacecloud.com,rackspace.net,rackspace.co.za,rackspacechess.com,rackspacemigrations.com,rackspace.nl,rackspace.com.hk,rackspacecloud.com,rackspacehosting.co.nz,rackspace.dk,rackspacehosting.no,rackspace.com.au,rackspace.com]
EVANZO e-commerce GmbH	[evanzo-server.de,evanzo.de]
ClaraNET LTD	[claranet.de,claranet.fr,claranet.nl,claranet.pt,claranet.com,claranet.es,declaranet.gob.mx,clara.net,claranet.co.uk]
GoDaddy.com LLC	[godaddytechfest.com,godaddymobile.com,godaddyconnections.com,test-godaddy.com,godaddycares.com,godaddytraininghub.com,godaddy.com,godaddy-payments.com]
Quality Technology Services LLC.	[qualitytech.com]
Softbank BB Corp.	[yd-softbank-cp.com,softbankselection.jp,softbankbb.co.jp,softbanktelecom.co.jp,softbankgift.co.jp,softbank.ne.jp,softbank.co.jp,softbanklab.biz,softbankmm.jp,softbankhc.jp,softbankcard.jp,softbankhc.co.jp,softbankmobile.co.jp,softbankworld.com,bic-softbank-cp.com,softbank.jp,softbanktelecom.com,softbankatwork.co.jp,softbanktech.jp,softbank.co.kr]
InMotion Hosting Inc.	[inmotionhosting.com,inmotion.net]
LeaseWeb B.V.	[leaseweb.nl,leaseweb.com,leaseweb.net,leasewebs.com,leaseweblabs.com,leasewebcdn.com,leaseweb.de,leaseweb.us,leaseweb.sg]
1&1 Internet AG	[1and1-editor-test.com,1and1-insider.co.uk,1and1training.com,1and1-storage.com,1and1.ca,1and1ayuda.com,1and1expertsupport.com,1and1-testing-free.com,1and1cdncloudflarejawn.com,1and1affilie.fr,1and1.info,1and1-comercia.es,1and1affiliate.com,webdesk-1and1.de,1and1test.co.uk,1and1.su,1and1.fr,1and1afiliados.es,1and1.com,1and1affiliate.co.uk,1and1.ro,1and1.org,1and1-storage.net,1and1-storage.eu,1and1.co.uk,static-1and1.com,1and1.mx,1and1.pl,1and1.it,1and1affiliati.it,1and1.es,cdntest1and1.com,1and1.eu,1and1turkey.com]
KAGOYA JAPAN Inc.	[kagoya.com,kagoya.net,kagoya-group.co.jp,kagoyacloud.com,kagoya.jp]
iWeb Technologies Inc.	[iweb.com]
SoftLayer Technologies Inc.	[softlayersurvey.com,softlayer.mobi,softlayer.net,softlayermexico.com,softlayer.com,softlayer.io,softlayerdomainsprivacy.com]
UK2 - Ltd	[uk2group.com,uk2techs.com,uk2net.com,uk2img.net]
Savvis	[savvisdirect.com,savvissl.com,savvisdrive.com,savviscterapoc1.com,savvisdirectmonitoring.com,savvis-spiff.com,savvis.com,savvis.net,savviscustomerloyalty.com]
Bit-isle Co.Ltd.	[bit-isle.ne.jp,bit-isle.co.jp,bit-isle.jp]
Media Temple Inc.	[mediatemple.net,mediatemple.tv]
Host Europe GmbH	[hosteurope.es,hosteurope.name,hosteurope-suisse.ch,hosteurope.com,hosteurope.link,hosteurope-vault-proxy.co.uk,hosteurope.ch,hosteuropegroup.com,hosteurope.de]
Digital Ocean Inc.	[digitalocean.co.za,digitalocean.net,digitalocean.com,digitaloceanstatus.com]
Zendesk Inc.	[zendesk.com.ru,zendesk.it,zendesk.com.mx,zendesk.jp,zendesk.fr,zendesk.com.br,zendesk.net,zendesk.co.jp,zendesk.tv,zendesk.mx,zendesk.es,zendesk.nl,zendesk.com,zendesk.de]
CyrusOne LLC	[gocyrusone.info,cyrusone.com,gocyrusone.com]
Microsoft Corporation	[microsoftstudentalumni.com,trymicrosoftoffice.com,microsoft.co.uk,microsoft.fr,microsoft.com,microsoftstore.com.cn,microsoftstore.com,microsoft-press.de]
Iomart	[iomartcloud.com,iomartmail.com,iomartdesktop.com,iomart.com,iomarthosting.com,iomartstorage.com]
Colo4 LLC	[]
COLT Technology Services Group Limited	[]
Rackspace Ltd.	[Rackspace Hosting]
Kagoya Japan COLTD	[KAGOYA JAPAN Inc.]
OVH Systems	[Ovh SAS]
